......................................................
......................................................
......................................................
.........................##...........................
...........................##.........................
#x....#......................##......................#
#"""""#.....#.....x..................#...............#
##xxxx......#........................................#
##xxxx...#####............."...""""".................#
######"""#############################################
